00000000000000000000
02111111311441114120
01111111311441114110
04444444041041114110
01111100031000114110
01111004111140014110
01110041111114004110
04440411111111404110
04400111344311100330
01111111444411134110
01143111444411111110
03300111344311100440
01140411111111404440
01140041111114001110
01141004111140011110
01141100013000111110
01141114014044444440
01141114411311111110
02141114411311111120
00000000000000000000
