00000000000000000000
02144444444444444120
01144444444444444110
04444444444444444440
04444444444400444440
04444444444004444440
04444444444004444440
04444444440004444440
04444444440000444440
04444444400400444440
04444444400440044440
04444444000440044440
04444334444444444440
04443444444444444440
04444344444444444440
04443444444444444440
04444334444444444440
01144444444444444110
02144444444444444120
00000000000000000000
