00000000000000000000
01111111311111111110
01000000044000000010
01000000421400000010
01000044411444000010
01000444444444400010
01004444444444440010
01004444444444440010
01044444344344444030
01411444444444412410
01421444444444411410
03044444344344444010
01004444444444440010
01004444444444440010
01000444444444400010
01000044411444000010
01000000412400000010
01000000044000000010
01111111111311111100
00000000000000000000
