00000000000000000000
02111111444011111120
01000010004000100010
01111110014110104410
04100000000011104410
00131111000000000110
01111101001111111110
01000001001000000000
01011103001000010100
01000104444440111110
01111104444440100010
00101000010030111010
00000000010010000010
00111111110010111110
01100000011111113100
01440111001000000140
01440101141001111110
01000100040001000010
02111111044411111120
00000000000000000000
